   #######
#### .# @#
#    W#  #
####$##$##
   #  #  #
   #  !  #
   #######