#######
# .# @#
#  #  #
#$##$##
#  #  #
#     #
#######