########
#   $  #
#  # #$#
#$$$.$ #
#  ### #
#     @#
########