###########
#@        #
##       ##
#R       R#
#N# # # #S#
#R       R#
##       ##
#        .#
###########