#########
#@      #
##   $ ##
#O!     #
#.      #
#########