 ############################
 #                          #
 # ######################## #
 # #                      # #
 # # #################### # #
 # # #                  # # #
 # # # ################ # # #
 # # # #              # # # #
 #$# # # ############ # # # #
 # # # # #            # # # #
 #.# # # # ############ # # #
 # # # # #              # # #
 #$# # # ################ # #
 # # # #                  # #
##$# # #################### #
#@   #                      #
#############################