#########
#@      #
#   ##  #
#   ##  #
#       #
#########
