#########
#@      #
##   $ ##
#O!     #
## $   ##
#!$   !W#
#.#     #
#########