############
#@         #
#          #
#         W#
###      ###
#O         #
#          #
#.         #
############