#########################
#.#z  X                 #
#Z##################### #
#Z      ############### #
#Z#@    #Y   z###y   X# #
#Z####    ########### # #
#   O x                 #
#########################