#########
#@     L#
#     $ #
#L    WL#
#LO    L##
# $    !.#
#       ##
#########