##########
#RR# .# @#
#RL  W#  #
####$##$##
   #  #  #
   #  !  #
   #######