   #######
#### .# @#
#   !W#  #
####$##$##
   #  #  #
   #  !  #
   #######