##############
# #          #
# Z   z    @ #
# #   x y    #
#.#   X Y    #
##############