###################
#@zzz    ####     #
#####Z##  Z   ###Z#
#     ########### #
#Z######### Z     #
#           #######
#########Z#########
#       zzz       #
####Z#### ###Z#####
#### ####Y### #####
###  ####z###  ####
###Z#####X####Z####
###y##### ####x####
#########.#########
