#######
# .# @#
#  #  #
# ## ##
#  #  #
#     #
#######