#######
# .# @#
#  #  #
#$ #$##
#  $  #
# $  ##
######