#######################
#.#z X     R    O   R #
#Z########            #
# #@     #    ####    #
# #      #    # x#    #
# #           #  #    #
#          R    W   R #
#                     #
#######################