#######################
#.#            x#@    #
#X#Oz           #     #
# ###########Y###     #
# #        S          #
#Z#y                  #
# ####                #
#                     #
#######################