#######################
#.#z X                #
#Z#Y######R     O   R #
# #z######    ####    #
# ###yz  #    # x#    #
#Z#@#    Z    #  #    #
#   ######R     W   R #
#                     #
#######################