############################
#.                         #
#  #   #   ######  ######  #
#NN#   # SS     #SS#    #NN#
#  #   #        #  #    #  #
#  ######  ######  #    #  #
#      #   #       #    #  #
#      #   #       #    #  #
#      #   ######  ######  #
#                         @#
############################