#############
#@          #
#OOO      # #
#      WWW# #
######### # #
#.          #
#############